Sentence	SentenceID	
แม่ไหว้พระพุทธรูป	correct_31	
ปู่เตรียมเครื่องเขียน	correct_16	
เด็กคนนี้มีกาลเทศะ	correct_34	
เธอสมัครเช่าชมรม	incorrect_27	
เรายืนเคารพธงชาติ	correct_11	
พี่บนบายกับศาลเจ้า	incorrect_24	
เขาไปงานรวมญาติ	correct_42	
พี่ชายสมัครเรียน	correct_1	
พี่สาวร้องเพลงเพราะ	correct_45	
พี่เป็นนักศึกษาฝึกงาน	correct_19	
เขาศึกษาหาความรู้	correct_36	
เธอทำข้อสอบเต็มที่	correct_39	
พี่นั่งบนแท็กซี่	correct_46	
น้าญาดาทำราดงาน	incorrect_23	
พ่ออ่านหนังสือธรรมะ	correct_3	
พี่ทบทวนคำศัพท์	correct_5	
พี่เขียนบทกลอน	correct_32	
พี่ธนาเขียนรายงาน	correct_18	
คืนนี้เป็นคืนวันเพ็ญ	correct_49	
น้องณัฐมาช่วยงาน	correct_15	
ครูสาธิตการเขียน	correct_12	
พี่เจอใบประกาศพิลึก	correct_43	
เพื่อนชวนไปเที่ยว	correct_47	
เขาปฏิบัติตามกฎ	correct_33	
เสียงดังเจี๊ยวจ๊าว	correct_41	
เขามีมารยาทดี	correct_2	
เธอร่วมงานสัมภาษณ์	correct_17	
ลุงเดินโขยกเขยก	correct_40	
เพื่อนต้องเกื้อกูลกัน	correct_44	
กฎเกณฑ์งานแข่งขัน	correct_50	
ลุงสะสมพระเครื่อง	correct_13	
เขาศึกษาภูมิศาจสร์	incorrect_22	
เขยฝึกปฏิบัติงาน	incorrect_25	
พ่อถือศีลห้า	correct_8	
ฉันช่วยสาธารณสุข	correct_20	
พี่เขีขนบทกลอน	incorrect_26	
แน่ถือธูปไหว้พระ	incorrect_21	
เธอรักษาความสะอาด	correct_14	
ฉันสวดมนต์ตอนเช้า	correct_10	
น้องชักธงชาติ	correct_9	
น้าธัญญาเป็นคนดี	correct_35	
ฉันร่วมงานทอดกฐิน	correct_48	
เธอเข้าร่วมกิจกรรม	correct_37	
พี่ญาดาทำการบ้าน	correct_7	
ป๊ะป๋าไปตีกอล์ฟ	correct_38	
เขาต้องกาสรมาธิ	incorrect_28	
แม่ชอบปฏิบัติธรรม	correct_4	
เขามีจิตเตตตา	incorrect_30	
พึ้ธิดาอ่านนิทาน	incorrect_29	
เขารักษาสัญญา	correct_6	
