Sentence	SentenceID	
ฉัร ช่วย สาธารณ สุข	incorrect_20	
เขา ศึกษา ภูมิศาสตร์	correct_22	
พี่ ทบทวน คำศัพท์	correct_5	
ปู่ เตรียม เครื่ยง เขียน	incorrect_16	
เธอ สมัคร เข้า ชมรม	correct_27	
พ่อ ถือ ศีล ห้า	correct_8	
ครู สาธิต การ เขีรย	incorrect_12	
เพื่อน ต้อง เกื้อกูล กัน	correct_44	
พี๊ธนา เขียน รายงาน	incorrect_18	
พี่ บนบาน กับ ศาลเจ้า	correct_24	
เขา มี มารยาท ดี	correct_2	
พ่อ อ่าน หนังสือ ธรรมะ	correct_3	
เขา ฝึก ปฏิบัติ งาน	correct_25	
พี่ ธิดา อ่าน นิทาน	correct_29	
พี่ เจอ ใบ ประกาศ พิลึก	correct_43	
เขา ไป งาน รวม ญาติ	correct_42	
เขา รักษา สัญญา	correct_6	
แม่ ชอบ ปฏิบัติธรรม	correct_4	
ฉัน ร่วม งาน ทอดกฐิน	correct_48	
น้า ธัญญา เป็น คนดี	correct_35	
เธอ รักษา ความ สะอยด	incorrect_14	
พี่ นั่ง บน แท็กซี่	correct_46	
เธอ ทำ ข้อสอบ เต็มที่	correct_39	
พี่ชาย สมัคร เรียน	correct_1	
พี่ เขียน บท กลอน	correct_32	
เสียง ดัง เจี๊ยวจ๊าว	correct_41	
เขา ปฏิบัติ ตาม กฎ	correct_33	
ลุง เดิน โขยกเขยก	correct_40	
ฉัน สวดมนต์ ตอนเช้า	correct_10	
คืนนี้ เป็น คืน วันเพ็ญ	correct_49	
เด็ก คนนี้ มี กาลเทศะ	correct_34	
พี่สาว ร้องเพลง เพราะ	correct_45	
น้ดงณัฐ มา ช่วยงาน	incorrect_15	
เขา ต้อง การ สมาธิ	correct_28	
พี่ ญาดา ทำ การบ้าน	correct_7	
เขา มี จิต เมตตา	correct_30	
เพื่อน ชวน ไป เที่ยว	correct_47	
แม่ ถือ ธูป ไหว้พระ	correct_21	
น้อง ชัก ธงชาติ	correct_9	
ป๊ะป๋า ไป ตี กอล์ฟ	correct_38	
ลุงบะ สม พระเครื่อง	incorrect_13	
พี่ เขียน บท กลอน	correct_26	
แม่ ไหว้ พระพุทธ รูป	correct_31	
กฎเกณฑ์ งาน แข่งขัน	correct_50	
เธอ ร่วมงาน สัมภอษณ์	incorrect_17	
น้า ญาดา ทำ รายงาน	correct_23	
เธอ เข้า ร่วม กิจกรรม	correct_37	
เขา ศึกษา หา ความรู้	correct_36	
เยา ยืน เคารพ ธงชาติ	incorrect_11	
พี่ เป็น นักศึจษา ฝึก งาน	incorrect_19	