Sentence	SentenceID	
เขา ศึกษา หา คยามรู้	incorrect_36	
พี่สาว ร้องเพลง เพราะ	correct_45	
คืนนี้ เป็น คืนวันเพ็ญ	correct_49	
แม่ ถือ ธูป ไหว้ พระ	correct_21	
เสียง ดัง เจี๊ยวจ๊าว	correct_41	
เด็ก คนนี้ มี กลลเทศะ	incorrect_34	
แม่ ไหว้ พระพุทรจูป	incorrect_31	
เขา มี จิตเมตตา	correct_30	
ลุง สะสม พระเครื่อง	correct_13	
พี่ ทบทวน คำศัพท์	correct_5	
เพื่อน ชวน ไป เที่ยว	correct_47	
ครู สาธิต การเขียน	correct_12	
เขา รักษา สัญญา	correct_6	
พี่ บนบาน กับ ศาลเจ้า	correct_24	
พี่ เขียน บทกลอน	correct_26	
เขา ไป งาน รวมญาติ	correct_42	
พี่ ญาดา ทำ การบ้าน	correct_7	
กฎเกณฑ์ งาน แข่งขัน	correct_50	
พี่ธิดา อ่าน นิทาน	correct_29	
น้องณัฐ มา ช่วยงาน	correct_15	
น้าญาดา ทำ รายงาน	correct_23	
ฉัน ช่วย สาธารณสุข	correct_20	
เธอ รักษา ความ สะอาด	correct_14	
ฉัน ร่วม งาน ทอดกฐิน	correct_48	
น่ะ ธัญญา เป็น คนดี	incorrect_35	
พ่อ ถือ ศีล ห้า	correct_8	
พี่ เขียน บทถลอน	incorrect_32	
เขา ต้อง การ สมาธิ	correct_28	
ป๊ะป๋า ไห ตี กอล์ป	incorrect_38	
พี่ เป็น นัก ศึกษา ฝึกงาน	correct_19	
พี่ชาย สมัคร เรียน	correct_1	
เรา ยืน เคารพ ธงชาติ	correct_11	
เธอ ทำ ข้อสอบ ตต็มที่	incorrect_39	
พี่ธนา เขียน รายงาน	correct_18	
เพื่อน ต้อง เกื้อกูล กัน	correct_44	
พ่อ อ่าน หนังสือธรรมะ	correct_3	
ปู่ เตรียม เครื่องเขียน	correct_16	
ฉัน สวดมนต์ ตอนเช้า	correct_10	
เขา ศึกษา ภูมิศาสตร์	correct_22	
แม่ ชอบ ปฏิบัติธรรม	correct_4	
พี่ เจอ ใบประกาศ พิลึก	correct_43	
เธอ เข้าร่วม กิตจรรม	incorrect_37	
เธอ สมัคร เข้า ชมรม	correct_27	
เขา มี มารยาทดี	correct_2	
พี่ นั่ง บน แท็กซี่	correct_46	
น้อง ชัก ธงชาติ 	correct_9	
ลุด เดิน โขยกเขยก	incorrect_40	
เขา ปติบัติ ตามกฎ	incorrect_33	
เขา ฝึก ปฏิบัติงาน	correct_25	
เธอ ร่วมงาน สัมภาษณ์	correct_17	