Sentence	SentenceID	
เธอทำข้อสอบเต็มที่	correct_39	
พี่เป็นนักศึกษาฝึกงาน	correct_19	
แม่ชอบปฏิบัติธรรม	correct_4	
พี่ญาดาทำการบ้าน	correct_7	
เขารักษาสัญญา	correct_6	
พี่ทบทวนคำศัพท์	correct_5	
เขามีมารยาทดี	correct_2	
พี่ชายสมัครเรียน	correct_1	
น้องณัฐมาช่วยงาน	correct_15	
เธอรักษาความสะอาด	correct_14	
เขาศึกษาภูมิศาสตร์	correct_22	
คืนนี้เป็นคืนวันเญ็พ	incorrect_49	
ฉันช่วยสาธารณสุข	correct_20	
ป๊ะป๋าไปตีกอล์ฟ	correct_38	
ครูสาธิตการเขียน	correct_12	
กฎเกต์ณงานแข่งขัน	incorrect_50	
พ่ออ่านหนังสือธรรมะ	correct_3	
พ่อถือศีลห้า	correct_8	
น้าธัญญาเป็นคนดี	correct_35	
แม่ไหว้พระพุทธรูป	correct_31	
เขาต้องการสมาธิ	correct_28	
พี่ธนาเขียนรายงาน	correct_18	
เธอเข้าร่วมกิจกรรม	correct_37	
เรายืนเคารพธงชาติ	correct_11	
เธอสมัครเข้าชมรม	correct_27	
เด็กคนนี้มีกาลเทศะ	correct_34	
เพื่อนค่องเกื้อกูลกัน	incorrect_44	
น้องชักธงชาติ	correct_9	
ฉันสวดมนต์ตอนเช้า	correct_10	
แม่ถือธูปไหว้พระ	correct_21	
เพื่อนชนวไปเที่ยว	incorrect_47	
พี่ธิดาอ่านนิทาน	correct_29	
พี่บนบานกับศาลเจ้า	correct_24	
เขาปฏิบัติตามกฎ	correct_33	
น้าญาดาทำรายงาน	correct_23	
พี่เขียนบทกลอน	correct_26	
พี่หาวร้องเพลงเพราะ	incorrect_45	
เสีดยดังเจี๊ยวจ๊าว	incorrect_41	
ลุงเดินโขยกเขยก	correct_40	
เขาฝึกปฏิบัติงาน	correct_25	
เขาไปงานรยมญาติ	incorrect_42	
พี่เจอใบประกาศพึลืก	incorrect_43	
ลุงสะสมพระเครื่อง	correct_13	
เขามีจิตเมตตา	correct_30	
เธอร่วมงานสัมภาษณ์	correct_17	
ปู่เตรียมเครื่องเขียน	correct_16	
พี่นั่งตนแท็กซี่	incorrect_46	
พี่เขียนบทกลอน	correct_32	
เขาศึกษาหาความรู้	correct_36	
ฉันร่วมงนาทอดกฐิน	incorrect_48	
